#### #### #### ####
#... .... .... ...#
#.## #.## ##.# ##.#
#.#. #.#. .#.# .#.#

#.## #.## ##.# ##.#
#... .... .... ...#
#.## #.## ##.# ##.#
#.#. #.#. .#.# .#.#

#.#. .... .... .#.#
#.## ..@@ @@.. ##.#
#... .... .... ...#
#.## .... .... ##.#

#... .... .... ...#
#.@@ @@@@ @@@@ @@.#
#... .... .... ...#
#### #### #### ####
1 e 0 3
5 1 2 3
e a 1 2
;
