#### #### #### ####
#... .... .... ...#
#.## #.## ##.# ##.#
#.#. #.#. .#.# .#.#

#.## #.## ##.# ##.#
#... .... .... ...#
#.## #.## ##.# ##.#
#.#. #.#. .#.# .#.#

#.#. .... .... .#.#
#.## ..@@ @@.. ##.#
#... .... .... ...#
#.## .... .... ##.#

#.#. #.#. .#.# .#.#
#.## #.## ##.# ##.#
#... .... .... ...#
#### #### #### ####
1 e 0 3 1 1 1 2 2
1 1 2 0 0
5 1 2 0 0
a 1 2 0 0
e 5 1 0 0
e a 1 0 0
e e 1 0 0
;
