#### #### #### ####
#... .... .... ...#
#... .... .... ...#
#... .... .... ...#

#... .@@% %@@. ...#
#... @... ...@ ...#
#... @... ...@ ...#
#... %... ...% ...#

#... %... ...% ...#
#... @... ...@ ...#
#... @... ...@ ...#
#... .@@% %@@. ...#

#... .... .... ...#
#... .... .... ...#
#... .... .... ...#
#### #### #### ####
